100 100
0000000000000000000000000000000000000000000000000000000000000000000000000000000000000000000000000000
0000000000000000000000000000000000000000000000000000000000000000000000000000000000000000000000000000
0000000000000000000000000000000000000000000000000000000000000000000000000000000000000000000000000000
0000000000000000000000000000000000000000000000000000000000000000000000000000000000000000000000000000
0000000000000000000000000000000000000000000000000000000000000000000000000000000000000000000000000000
0000000000000000000000000000000000000000000000000000000000000000000000000000000000000000000000000000
0000000000000000000000000000000000000000000000000000000000000000000000000000000000000000000000000000
0000000000000000000000000000000000000000000000000000000000000111111000022222222200000000000000000000
0000000000000000000000000000000000000000000000000000000001111111111111222222222222000000000000000000
0000000000000000000000000000000000000000000000000000011111111111111112222222222222200000000000000000
0000000000000000011111110000000000000000000000000111111111111111111122222222222222211111110000000000
0000000000000000111111111111110000000000000001111111111111111111111122222222222222221111111100000000
0000000000000001111111111111111111111111111111111111111111111111111222222222222222221111111110000000
0000000000000011111111111111111111111111111111111111111111111111111222222233332222221111111110000000
0000000000000011111333333331111111111111111111111112222221111111111222222333333222221111111110000000
0000000000000111113333333333333311111111111111111222222222111111111222222333333222221111111110000000
0000000000000111133333333333333333333333333111112222222222211111112222222333333222221111111100000000
0000000000000111133333333333333333333333333333333222222222221111112222222233333222221111100000000000
0000000000001111133333333333333333333333333333333332222222222111122222222223332222221100000000000000
0000000000001111133333333333333333333333333333333333322222222222222222222222222222220000000000000000
0000000000001111133333333333333222223333333333333333332222222222222222222222222222200000000000000000
0000000000001111133333333333322222222233333333333333332222222222222222222222222222200000000000000000
0000000000001111113333333333222222222223333333333333332222222222222222222222222222000000000000000000
0000000000001111113333333333222222222222233333333333333222222222222222222222222220000000000000000000
0000000000000111111333333333222222222222223333333333333222222222222222222222222220000000022000000000
0000000000000111111333333333222222222222222333333333333322222222222222222222222200000000222200000000
0000000000000011111133333333322222222222222233333333333322222222222222222222222200000002222220000000
0000000000000001111113333333332222222222222233333333333332222222333322222222222000000002222220000000
0000000000000000111113333333333322222222222233333333333333322223333332222222220000000000222220000000
0000000000000000011111333333333333222222222333333333333333333333333332222222200000000000022200000000
0000000000000000001111133333333333332222223333333333333333333333333332222222200000000000000000000000
0000000000000000001111113333333333333333333333333333333333333333333322222222000000000000000000000000
0000000000000000000111111333333333333333333333333333333333333333333322222220000000000000000000000000
0000000000000000000011111133333333333333333333333333333333333333333222222220000000000000000000000000
0000000000000000000011111113333333333333333333333333333333333333332222222200000000000000000000000000
0000000000000000000001111111333333333333333331113333333333333333322222222000000000000000000000000000
0000000000000000000001111111133333333333333311111333333333333333222222222000000000000000000000000000
0000000000000000000000111111113333333333333311111333333333333322222222220000000000000000000000000000
0000000000000000000000111111111333333333333111111333333333332222222222220000000000000222333000000000
0000000000000000000000111111111133333333333111111333333333222222222222200000000000002222333300000000
0000000000000000000000011111111113333333333111111333333332222222222222200000000000022222333330000000
0000000000000000000000011111111111333333333111111333333322222222222222000000000000222222333333000000
0000000000000000000000001111111111133333333111113333333222222222222221000000000000222222333333000000
0000000002222200000000001111111111113333333111113333333222222222222211000000000002222211333333000000
0000000112222222000000000111111111113333331111113333332222222222222111000000000022222111133333000000
0000000122222222200000000011111111111333331111133333332222222222221111000000000022221111111133000000
0000001122222222220000000011111111111333331111133333332222222222111111000000000011111111111111000000
0000011122233222220000000001111111111333331111333333332222221111111110000000000011111111111111000000
0000011222333322220000000000111111111333311113333333322222111111111110000000000011111111111111000000
0000011222333332220000000000111111113333311113333333322111111111111110000000000011111111111110000000
0000011222233332220000000000011111113333311133333333311111111111111110000000000001111111111110000000
0000011222223322220000000000011111113333333333333333311111111111111110000000000000111111111100000000
0000001122222222200000000000011111133333333333333333111111111111111110000000000000000111111000000000
0000000122222222000000000000111111133333333333333333111111111111111100000000000000000000000000000000
0000000022222220000000000000111111133333333333333331111111122211111100000000000000000000000000000000
0000000002222200000000000000111111333333333333333331111111222221111100000000000000000000000000000000
0000000000000000000000000001111113333333333333333311111112222221111100000000000000000000000000000000
0000000000000000000000000001111133333333333333333111111122222221111000000000000000000000000000000000
0000000002200000000000000011111333333333333333331111111122222221111000000000000000000000000000000000
0000000022220000000000000111113333333333333333311111111222222221111000000000000000000000000000000000
0000000222222000000000001111133333333333333333111111111222222221111000000000000000000000000000000000
0000002222222000000000001111333333333333333331111111111222222211110000000000000000000000000000000000
0000002222222000000000011113333333333333333311111111111122222111110000000000000000000333330000000000
0000000002220000000000111133333333333333333111111111111111111111110000000000000000333333333300000000
0000000000000000000000111333333333333333331111111111111111111111100000000000000003333333333300000000
0000000000000000000001113333333333333333311111133333111111111111100000000000000033333333333330000000
0000000022000000000011133333333333333333111111333333311111111111100000000000000333333333333330000000
0000000222000000000011333333333333333331111113333333331111111111100000000000033333333333333330000000
0000002222000000000111333333333333333311111133333333331111111111000000000000333333322333333330000000
0000002222000000000111333333333333333111111333333333331111111111000000000003333333222223333333000000
0000000220000000000111333333333333331111113333333333331111111110000000000033333332222222233333000000
0000000000000000000111133333333333111111133333333333331111111110000000000333333332222222223333000000
0000000000000000000111113333333311111111333333333333331111111110000000000333333332222222223333000000
0000222000000000000111111333331111111113333333333333331111111100000000003333333332222222233333000000
0000222000000000000111111111111111111113333333333333311111111100000000003333333333222222333333300000
0000022000000000000111111111111111111113333333333333111111111000000000033333333333332233333333300000
0000000000000000000111111111111111111113333333333331111111111000000000033333333333333333333333300000
0000000000000000001111111111111111111111333333333311111111110000000000033333333333333333333333300000
0000000000000000001111111111111111111111113333331111111111110000000000033333333333333333333333300000
0000000000000000001111111111111111111111111111111111111111100000000000033333333333333333333333300000
0000000000000000011111111111111111111111111111111111111111100000000000013333333333333333333333300000
0000000000000000111111111111111111111111111111111111111111000000000000011133333333333333333333300000
0000000000000001111111111111111111111111111111111111111111000000000000011111333333333333333333300000
0000000000000111111111111111111111111111111111111111111110000000000000011111111333333333333333100000
0000011100000111111111111111111111111111111111111111111110000000000000011111111111133333333311100000
0001111100000000000111111111111111111111111111111111111100000000000000011111111111111111111111000000
0001111100000000000000000011111111111111111111111111110000000000000000001111111111111111111111000000
0000111000000000000000000000000011111111111111111110000000000000000000000111111111111111111111000000
0000000000000000000000000000000000000111111111110000000000000000000000000111111111111111111111000000
0000000000000000000000000000000000000001111111000000000000000000000000000011111111111111111110000000
0000000000000000000000000000000000000000011110000000000000000000000000000000111111111111111100000000
0000000000000000000000000000000000000000001100000000000000000000000000000000001111111111111000000000
0000000000000000000000000000000000000000000000000000000000000000000000000000000001111111100000000000
0000000000000000000000000000000000000000000000000000000000000000000000000000000000000000000000000000
0000000000000000000000000000000000000000000000000000000000000000000000000000000000000000000000000000
0000000000000000000000000000000000000000000000000000000000000000000000000000000000000000000000000000
0000000000000000000000000000000000000000000000000000000000000000000000000000000000000000000000000000
0000000000000000000000000000000000000000000000000000000000000000000000000000000000000000000000000000
0000000000000000000000000000000000000000000000000000000000000000000000000000000000000000000000000000
0000000000000000000000000000000000000000000000000000000000000000000000000000000000000000000000000000
